########### ############
#         # #. . .    .#
#         # # ####  o  #
#  ####   # # #  #     #
#  #oo#   # # #  #  #  #
# #####   # # #  #  #  #
# #####   # # ####  #  #
#  ####   # #          #
#  #  #   # ############
#         #             
###########             
